0 0 0 0 0 0
0 0 0 0 0 0
0 0 0 0 0 0
0 0 0 0 0 0
6 3 0 0 0 0
3 8 0 0 0 0
