0 0 0 0 0 0
0 0 0 0 0 0
0 0 3 5 9 0
0 0 5 7 3 0
0 0 4 9 3 0
0 0 0 0 0 0
