8 8 7 0 0 0 0
1 6 9 0 0 0 0
6 9 4 0 0 0 0
0 0 0 0 0 0 0
0 0 0 0 0 0 0
