0 0 0 0 0
0 0 0 0 0
0 0 0 0 0
0 0 0 5 9
0 0 0 8 6
