1 9 3 0 0
8 4 8 0 0
5 10 4 0 0
0 0 0 0 0
0 0 0 0 0
0 0 0 0 0
0 0 0 0 0
