0 0 0 0 0
0 0 0 0 0
0 0 0 0 0
0 8 1 0 0
0 9 2 0 0
0 0 0 0 0
0 0 0 0 0
