0 0 0 0 0
0 3 7 1 0
0 1 3 7 0
0 8 4 5 0
0 0 0 0 0
