0 0 0 0 0
0 0 0 0 0
0 3 9 5 0
0 5 7 8 0
0 7 9 4 0
0 0 0 0 0
0 0 0 0 0
