0 0 0 0 0
8 1 5 0 0
9 3 5 0 0
9 1 3 0 0
0 0 0 0 0
