0 0 0 0 0 0
0 0 0 0 0 0
4 7 7 0 0 0
6 8 5 0 0 0
4 4 7 0 0 0
0 0 0 0 0 0
