0 0 0 0 0
0 0 0 0 0
0 3 5 0 0
0 4 2 0 0
0 0 0 0 0
0 0 0 0 0
0 0 0 0 0
