10 2 10 0 0 0
6 1 5 0 0 0
4 2 7 0 0 0
0 0 0 0 0 0
0 0 0 0 0 0
0 0 0 0 0 0
