0 0 0 0 0
0 0 0 0 0
0 0 0 0 0
0 0 0 0 0
0 0 7 8 5
0 0 1 2 9
0 0 9 6 4
