0 0 0 0 0 0 0
2 3 0 0 0 0 0
8 4 0 0 0 0 0
0 0 0 0 0 0 0
0 0 0 0 0 0 0
