0 0 0 0 0
2 6 6 0 0
6 9 6 0 0
6 2 9 0 0
0 0 0 0 0
