0 0 5 6 4
0 0 4 8 2
0 0 8 6 5
0 0 0 0 0
0 0 0 0 0
