0 0 0 0 0
0 0 9 8 7
0 0 5 1 1
0 0 5 9 2
0 0 0 0 0
0 0 0 0 0
0 0 0 0 0
