0 0 0 0 0 0 0
0 0 0 0 0 0 0
0 0 0 0 0 0 0
7 1 0 0 0 0 0
3 5 0 0 0 0 0
