0 0 0 0 0
0 0 0 0 0
0 0 0 0 0
0 0 0 0 0
5 5 10 0 0
7 5 2 0 0
3 1 3 0 0
