0 0 0 0 0
0 0 0 0 0
0 0 0 0 0
0 0 0 0 0
0 0 3 5 4
0 0 5 3 7
0 0 1 7 7
