0 0 0 0 0 0 0
0 0 1 4 2 0 0
0 0 8 6 4 0 0
0 0 2 1 5 0 0
0 0 0 0 0 0 0
