9 4 1 0 0 0 0
6 8 2 0 0 0 0
2 4 1 0 0 0 0
0 0 0 0 0 0 0
0 0 0 0 0 0 0
