0 0 0 0 0 0
0 0 0 0 0 0
0 0 3 5 5 0
0 0 8 7 4 0
0 0 2 5 6 0
0 0 0 0 0 0
