0 0 4 7 1
0 0 9 5 3
0 0 6 2 4
0 0 0 0 0
0 0 0 0 0
