0 0 0 0 0 0
0 0 0 0 0 0
0 0 0 0 0 0
0 0 0 5 8 1
0 0 0 1 8 10
0 0 0 3 8 3
