0 0 0 0 0
0 2 6 4 0
0 1 3 7 0
0 7 2 3 0
0 0 0 0 0
