9 2 8 0 0
9 7 5 0 0
9 3 3 0 0
0 0 0 0 0
0 0 0 0 0
0 0 0 0 0
0 0 0 0 0
