0 0 0 0 0 0
0 0 0 0 0 0
0 0 4 5 10 0
0 0 8 8 2 0
0 0 4 9 7 0
0 0 0 0 0 0
