0 0 0 0 0
0 0 0 0 0
0 0 0 0 0
0 0 0 0 0
0 0 7 2 8
0 0 5 1 3
0 0 2 4 6
