4 10 2 0 0 0
9 5 6 0 0 0
7 8 6 0 0 0
0 0 0 0 0 0
0 0 0 0 0 0
0 0 0 0 0 0
