0 0 0 0 0
0 0 0 0 0
4 4 9 0 0
6 9 2 0 0
1 5 3 0 0
0 0 0 0 0
0 0 0 0 0
