0 0 0 0 0
0 6 6 9 0
0 7 3 5 0
0 2 4 5 0
0 0 0 0 0
