0 0 0 0 0 0 0
7 5 0 0 0 0 0
8 2 0 0 0 0 0
0 0 0 0 0 0 0
0 0 0 0 0 0 0
