0 0 0 0 0 0
0 0 0 0 0 0
0 0 2 6 9 0
0 0 4 4 1 0
0 0 2 8 10 0
0 0 0 0 0 0
