0 0 8 1 9
0 0 3 3 10
0 0 3 5 4
0 0 0 0 0
0 0 0 0 0
0 0 0 0 0
0 0 0 0 0
