7 2 4 0 0
2 3 3 0 0
2 10 2 0 0
0 0 0 0 0
0 0 0 0 0
0 0 0 0 0
0 0 0 0 0
