0 0 7 8 3
0 0 6 7 8
0 0 6 3 3
0 0 0 0 0
0 0 0 0 0
0 0 0 0 0
0 0 0 0 0
