0 0 0 0 0 0
0 0 0 0 0 0
0 0 0 0 0 0
0 0 0 6 3 3
0 0 0 10 6 2
0 0 0 7 5 9
