0 0 0 0 0
0 4 7 0 0
0 6 7 0 0
0 0 0 0 0
0 0 0 0 0
