0 0 0 0 0
0 0 0 0 0
0 0 0 0 0
9 6 0 0 0
9 3 0 0 0
