0 0 0 0 0 0 0
0 0 0 0 0 0 0
5 1 2 0 0 0 0
3 4 8 0 0 0 0
4 5 3 0 0 0 0
