2 2 5 0 0
5 4 7 0 0
2 6 5 0 0
0 0 0 0 0
0 0 0 0 0
0 0 0 0 0
0 0 0 0 0
