0 0 0 0 0 0
0 0 0 0 0 0
0 0 0 0 0 0
0 2 6 2 0 0
0 1 2 1 0 0
0 5 4 6 0 0
