3 9 4 0 0
1 1 5 0 0
6 1 4 0 0
0 0 0 0 0
0 0 0 0 0
