0 0 0 0 0
0 0 0 0 0
0 1 5 0 0
0 9 3 0 0
0 0 0 0 0
0 0 0 0 0
0 0 0 0 0
