0 0 0 0 0 0
0 0 0 0 0 0
0 0 8 7 0 0
0 0 7 1 0 0
0 0 0 0 0 0
0 0 0 0 0 0
