0 0 0 0 0
0 0 0 0 0
7 2 2 0 0
4 6 3 0 0
2 2 9 0 0
