0 0 0 0 0 0
0 0 0 0 0 0
0 0 9 7 2 0
0 0 5 10 8 0
0 0 8 9 4 0
0 0 0 0 0 0
